8 8
3
SSSSSSSS
........
........
........
........
........
........
........
Easy
--------
H..S...M
M..M...S
..S.....
........
....S..M
SSS...S.
........
........
Easy
--------
HHHHHHHH
........
M....M..
S..M..S.
.......S
..S..S..
........
........
Easy
--------